1111111111
1010001111
1010111101
1000100001
1110101111
1110000111
1111011111
1011000011
1000011001
1111111111

