1111111111111
1010001100111
1010101110101
1000111100001
1110101001011
1100001010011
1101100010111
1001001100011
1101011111011
1001001100011
1111111111111

